CENTER_POS,3,0,8,,,,16,6,
,0,0,0,0,0,0,0,,
0,5,5,5,5,5,5,5,0,x
0,5,9,5,9,5,9,5,0,x
0,5,5,5,5,5,5,5,0,x
0,5,5,5,5,5,5,5,0,x
0,5,5,5,5,5,5,5,0,x
0,5,5,9,5,9,5,5,0,x
0,5,5,5,9,5,5,5,0,x
0,5,5,5,5,5,5,5,0,x
0,5,5,5,5,5,5,5,0,x
,0,0,5,5,5,0,0,,x
,,0,5,5,5,0,,,x
,0,0,5,5,5,0,0,,x
0,1,5,5,5,5,5,2,0,x
0,5,5,5,5,5,5,5,0,x
0,5,5,5,5,5,5,5,0,x
0,5,5,5,5,5,5,5,0,x
0,3,5,5,5,5,5,4,0,x
,0,0,0,0,0,0,0,,
,y,y,y,y,y,y,y,,
