ステージ,生成,,,,,,,,,,
0,0,0,0,0,0,0,0,0,0,0,
0,3,5,5,5,5,5,5,5,5,1,
0,5,5,5,5,5,5,5,5,5,5,
0,5,5,5,5,5,5,5,5,5,5,
0,5,5,5,5,5,5,5,5,5,5,
0,5,5,0,0,0,5,5,5,5,5,
0,5,5,0,0,0,5,5,5,5,5,
0,5,5,5,5,5,5,5,5,5,5,
0,5,5,5,5,5,5,5,5,5,5,5
0,4,5,5,5,5,5,5,5,5,5,2
